######################
#                    #
#                    #
#                    #
#                    #
#                    #
#                    #
#     ################
#                    #
#     # # #          #
#     # # #          #
#         #          #
######### #          #
#         #          #
# ##########         #
#                    #
######################