##########################################
#                                        #
#                                        #
#                                        #
#                                        #
#                                        #
#                                       ##
#                                        #
#                                        #
##########################################